0000000000
2000010000
0002000010
0200000100
0000000000
0000000000
0200000100