0000000000
2000000000
0002000000
0200000000
0000000000
0000000000
0200000000